C2 WH WH T1 WH WH WH WH WH WH T1 WH WH WH WH C1
WV MA BT WV BT BT BT BT BT BT WV BT BT BT BT WV
WV BT BT WV BT BT BT BT BT BT WV BT BT BT BT WV
WV BT BT WV BT BT BT BT BT BT WV BT BT BT BT WV
WV BT BT WV BT BT BT BT BT BT VB BT BT BT BT WV
WV BT BT WV BT BT BT BT BT BT BT BT BT BT BT WV
WV BT BT VB D1 HL WH WH WH WH WH WH WH WH WH WV
WV BT BT BT BT B1 BT BT BT BT BT BT BT BT BT WV
WV BT BT BT BT BT BT BT BT BT BT BT BT BT FE WV
C3 WH WH WH WH WH WH WH WH WH WH WH WH WH WH C4
