C2 WH T1 WH WH WH WH WH WH WH T1 WH WH WH WH C1
WV MA WV BT BT BT BT BT BT BT WV BT BT BT BT WV
WV BT WV BT BT BT BT BT BT BT WV BT BT BT BT WV
WV BT WV BT BT BT BT BT BT BT WV BT BT BT BT WV
WV BT WV BT BT BT BT BT BT BT VB BT BT BT BT WV
WV BT WV BT BT BT BT BT BT BT BT BT BT BT BT WV
WV BT WV BT BT BT BT BT BT BT BT BT BT BT BT WV
WV BT VB BT BT HL WH WH WH WH WH WH WH WH WH WV
WV BT BT BT BT BT B1 BT BT BT BT BT BT BT FE WV
C3 WH WH WH WH WH WH WH WH WH WH WH WH WH WH C4
